3   4   5   4   5   4   5   4   5   4   5   4   5   4   5   4   5   6
15  0   0   0   0   0   0   0   0   0   0   0   0   0   0   0   0   7
16  0   32  0   32  0   32  0   32  0   32  0   32  0   0   0   0   8
17  0   0   0   0   0   0   0   0   0   0   0   0   0   0   0   0   9
15  0   0   0   0   0   0   0   0   0   0   0   0   0   0   0   0   7
15  0   0   0   0   0   0   0   0   0   0   0   0   0   0   0   0   7
15  1   0   1   0   1   0   1   0   1   0   1   0   1   1   1   1   7
15  64  0   0   0   0   0   0   0   0   0   0   0   1   0   1   0   7
16  1   0   1   0   1   0   1   0   1   0   1   0   1   0   0   0   8
17  128 0   0   0   0   0   0   0   0   0   0   0   0   0   0   0   9
15  1   64  1   128 1   64  1   128 1   64  1   128 1   0   0   0   7
10  11  12  13  14  10  11  12  13  14  10  11  12  13  14  10  11  12