1 1 1 1 1 1 1 1 1 1 1 1 1 1 1 1 1 1
1 0 0 0 0 0 0 0 0 0 0 0 0 0 0 0 0 1
1 0 0 0 0 0 8 8 0 8 0 8 0 8 8 8 0 1
1 0 0 0 0 8 0 0 0 0 0 0 0 1 1 1 0 1
1 1 0 1 0 1 0 1 0 1 0 0 0 0 0 1 0 1
1 16 0 0 0 0 0 0 8 0 0 0 0 1 0 1 0 1
1 1 0 1 0 1 0 1 0 1 0 0 0 1 1 1 0 1
1 32 0 0 0 0 0 0 0 0 0 0 0 0 0 0 0 1
1 1 0 1 0 1 0 1 0 1 0 0 0 0 0 0 0 1
1 16 0 0 0 0 0 0 0 0 0 0 0 0 0 0 0 1
1 1 32 1 16 1 32 1 16 1 0 0 0 0 0 0 0 1
1 1 1 1 1 1 1 1 1 1 1 1 1 1 1 1 1 1